{"width": 40, "height": 40, "data":[
0,0,0,0,0,0,0,0,0,0,0,0,0,0,0,0,0,0,0,0,0,0,0,0,0,0,0,0,0,0,0,0,0,0,0,0,0,0,0,0,
0,0,0,0,0,0,0,0,0,0,0,0,0,0,0,0,0,0,0,0,0,0,0,0,0,0,0,0,0,0,0,0,0,0,0,0,0,0,0,0,
0,0,0,0,0,7,7,0,0,0,0,0,0,0,0,0,0,0,0,0,0,0,0,0,0,0,0,0,0,0,0,0,0,7,7,0,0,0,0,0,
0,0,0,0,0,7,7,0,0,0,0,0,0,0,7,7,0,0,0,0,0,0,0,0,7,7,0,0,0,0,0,0,0,7,7,0,0,0,0,0,
0,0,0,0,0,7,7,0,0,0,0,0,0,0,7,7,0,0,0,0,0,0,0,0,7,7,0,0,0,0,0,0,0,7,7,0,0,0,0,0,
0,0,0,7,7,7,7,7,7,7,0,0,7,7,7,7,7,7,0,0,0,0,7,7,7,7,7,7,0,0,0,7,7,7,7,7,7,0,0,0,
0,0,0,7,7,7,7,7,7,7,0,0,7,7,7,7,7,7,0,7,7,0,7,7,7,7,7,7,0,0,0,7,7,7,7,7,7,0,0,0,
0,0,0,0,0,7,7,0,0,0,0,0,0,0,7,7,0,0,0,7,7,0,0,0,7,7,0,0,0,0,0,0,0,7,7,0,0,0,0,0,
0,0,0,0,0,7,7,0,0,0,0,0,0,0,7,7,0,0,0,7,7,0,0,0,7,7,0,0,0,0,0,0,0,7,7,0,0,0,0,0,
0,0,0,0,0,0,0,0,7,7,0,0,0,0,0,0,0,0,0,7,7,0,0,0,0,0,0,0,0,0,7,7,0,0,0,0,0,0,0,0,
0,0,0,0,0,0,0,0,7,7,0,0,0,0,0,0,0,0,0,7,7,0,0,0,0,0,0,0,0,0,7,7,0,0,0,0,0,0,0,0,
0,0,0,0,0,0,7,7,7,7,7,7,0,0,0,7,7,7,7,7,7,7,7,7,7,0,0,0,7,7,7,7,7,7,0,0,0,0,0,0,
0,0,0,0,0,0,7,7,7,7,7,7,0,0,0,7,7,7,7,7,7,7,7,7,7,0,0,0,7,7,7,7,7,7,0,0,0,0,0,0,
0,0,0,0,0,0,0,0,7,7,0,0,0,0,0,0,0,0,0,7,7,0,0,0,0,0,0,0,0,0,7,7,0,0,0,0,0,0,0,0,
0,0,0,0,0,0,0,0,7,7,0,0,0,0,0,0,0,0,0,7,7,0,0,0,0,0,0,0,0,0,7,7,0,0,0,0,0,0,0,0,
0,0,0,0,0,0,0,0,0,0,0,7,7,0,0,0,0,0,0,7,7,0,0,0,0,0,0,0,7,7,0,0,0,0,0,0,0,0,0,0,
0,0,0,0,0,0,0,0,0,0,0,7,7,0,0,0,0,0,0,7,7,0,0,0,0,0,0,0,7,7,0,0,0,0,0,0,0,0,0,0,
0,0,0,0,0,0,0,0,0,0,0,7,7,0,0,0,0,0,0,0,0,0,0,0,0,0,0,0,7,7,0,0,0,0,0,0,0,0,0,0,
0,0,0,0,0,0,0,0,0,0,0,7,7,0,0,0,0,0,0,0,0,0,0,0,0,0,0,0,7,7,0,0,0,0,0,0,0,0,0,0,
7,7,7,7,0,0,7,7,7,7,7,7,7,7,7,7,0,0,0,0,0,0,0,0,7,7,7,7,7,7,7,7,7,7,0,0,7,7,7,7,
7,7,7,7,0,0,7,7,7,7,7,7,7,7,7,7,0,0,0,0,0,0,0,0,7,7,7,7,7,7,7,7,7,7,0,0,7,7,7,7,
0,0,0,0,0,0,0,0,0,0,0,7,7,0,0,0,0,0,0,0,0,0,0,0,0,0,0,0,7,7,0,0,0,0,0,0,0,0,0,0,
0,0,0,0,0,0,0,0,0,0,0,7,7,0,0,0,0,0,0,0,0,0,0,0,0,0,0,0,7,7,0,0,0,0,0,0,0,0,0,0,
0,0,0,0,0,0,0,0,0,0,0,7,7,0,0,0,0,0,0,7,7,0,0,0,0,0,0,0,7,7,0,0,0,0,0,0,0,0,0,0,
0,0,0,0,0,0,0,0,0,0,0,7,7,0,0,0,0,0,0,7,7,0,0,0,0,0,0,0,7,7,0,0,0,0,0,0,0,0,0,0,
0,0,0,0,0,0,0,0,7,7,0,7,7,0,0,0,0,0,0,7,7,0,0,0,0,0,0,0,0,0,7,7,0,0,0,0,0,0,0,0,
0,0,0,0,0,0,0,0,7,7,0,0,0,0,0,0,0,0,0,7,7,0,0,0,0,0,0,0,0,0,7,7,0,0,0,0,0,0,0,0,
0,0,0,0,0,0,7,7,7,7,7,7,0,0,0,7,7,7,7,7,7,7,7,7,7,0,0,0,7,7,7,7,7,7,0,0,0,0,0,0,
0,0,0,0,0,0,7,7,7,7,7,7,0,0,0,7,7,7,7,7,7,7,7,7,7,0,0,0,7,7,7,7,7,7,0,0,0,0,0,0,
0,0,0,0,0,0,0,0,7,7,0,0,0,0,0,0,0,0,0,7,7,0,0,0,0,0,0,0,0,0,7,7,0,0,0,0,0,0,0,0,
0,0,0,0,0,0,0,0,7,7,0,0,0,0,0,0,0,0,0,7,7,0,0,0,0,0,0,0,0,0,7,7,0,0,0,0,0,0,0,0,
0,0,0,0,0,7,7,0,0,0,0,0,0,0,0,0,0,0,0,7,7,0,0,0,7,7,0,0,0,0,0,0,0,7,7,0,0,0,0,0,
0,0,0,0,0,7,7,0,0,0,0,0,0,0,7,7,0,0,0,7,7,0,0,0,7,7,0,0,0,0,0,0,0,7,7,0,0,0,0,0,
0,0,0,0,0,7,7,0,0,0,0,0,0,0,7,7,0,0,0,7,7,0,0,0,7,7,0,0,0,0,0,0,0,7,7,0,0,0,0,0,
0,0,0,7,7,7,7,7,7,7,0,0,7,7,7,7,7,7,0,0,0,0,7,7,7,7,7,7,0,0,0,7,7,7,7,7,7,0,0,0,
0,0,0,7,7,7,7,7,7,7,0,0,7,7,7,7,7,7,0,0,0,0,7,7,7,7,7,7,0,0,0,7,7,7,7,7,7,0,0,0,
0,0,0,0,0,7,7,0,0,0,0,0,0,0,7,7,0,0,0,0,0,0,0,0,7,7,0,0,0,0,0,0,0,7,7,0,0,0,0,0,
0,0,0,0,0,7,7,0,0,0,0,0,0,0,7,7,0,0,0,0,0,0,0,0,7,7,0,0,0,0,0,0,0,7,7,0,0,0,0,0,
0,0,0,0,0,0,0,0,0,0,0,0,0,0,0,0,0,0,0,0,0,0,0,0,0,0,0,0,0,0,0,0,0,0,0,0,0,0,0,0,
0,0,0,0,0,0,0,0,0,0,0,0,0,0,0,0,0,0,0,0,0,0,0,0,0,0,0,0,0,0,0,0,0,0,0,0,0,0,0,0]}